map.png
5 70 70
1 576 864 70 70
2 504 216 70 70
3 720 864 70 70
S 0 0 352 287
E 72 0 70 70

111111111111111111111111111111111111
100000000000000000000000000000000001
100000000000000000000000000000000001
100S00E00000000000000000000000000001
100000000000000000000000000000000001
100000000000000000000000000000000001
100000000000000000000000000000000001
100000000000000000000000000000000001
100000000000000000000000000000000001
100000000000000000000000000000000001
100000000000000000000000000000000001
100000000000000000000000000000000001
100000000000000000000000000000000001
100000000000000000000000000000000001
100000000000000000000000000000000001
100000000000000000000000000000000001
100000000000000000000000000000000001
100000000000000000000000000000000001
100000000000000000000000000000000001
111111111111111111111111111111111111