map.png
3 70 70
1 576 864 70 70
2 504 216 70 70
3 720 864 70 70

111100010000000000000000000000000000
122222222222222222222222222222222221
122222222222222222222222222222222221
122222222222222222222222222222222221
122222222222222222222222222222222221
122222222222222222222222222222222221
122222222222222222222222222222222221
122222222222222222222222222222222221
122222222222222222222222222222222221
122222222222222222222222222222222221
122222222222222222222222222222222221
122222222222222222222222222222222221
122222222222222222222222222222222221
122222222222222222222222222222222221
111111111111111111111111111111111111
