map.png
4 70 70
1 576 864 70 70
2 504 216 70 70
3 720 864 70 70
E 72 0 70 70

111111111111111111111111111111111111
122222222222222222222222222222222221
122E22222222222222222E22222222222221
122222222222222222222222222222222221
1222222222222222222E2222222222222221
1222222222222222222222222E2222222221
122222222222222222222222222222222221
122222222222222222222222222222222221
122222222222222222222222222222222221
122222222222222222222222222222222221
122222222222222222222222222222222221
122222222222222222222222222222222221
122222222222222222222222222222222221
122222222222222222222222222222222221
111111111111111111111111111111111111