map.png
5 70 70
1 576 864 70 70
2 504 216 70 70
3 720 864 70 70
S 0 0 352 287
E 72 0 70 70

111111111111111111111111111111111111
100000000000000000000000000000000001
100000000000000000000E00000000E00001
100S00000000000000000000000000000001
10000000000E0000000E0000000000000001
1000000000000000000000000E0000000001
100000000000000000000000000000000001
1000E0000000E00000000000000000000001
10000E000000000000E00000000000000001
10000000000000000000000000000E000001
10000000E000E00000000000000000000001
100000000000000000000000000000000001
10000000000000000000E000000000000001
1000E0000000000000000000000E00000001
100000000E00000000000000000000000001
100000000000000000000000000000000001
1000000000000000000E000000E000000001
1000000E0000000000000000000000000001
100000000000000000000000000000000001
111111111111111111111111111111111111