map.png
5 70 70
1 576 864 70 70
2 504 216 70 70
3 720 864 70 70
S 0 0 237 195
E 504 0 70 70

111111111111111111111111111111111111
100000000000000000000000000000000001
100000000000000000000000000000000001
100000000000000000000000000000000001
100000000000000000000000000000000001
100000000S0E000000000000000000000001
100000000000000000000000000000000001
10000E0000000000000E0000000000000001
1000000000000000000000000E0000000001
10000000000E0000E0000000000000000001
100000000000000000000000000E00000001
1000000000E0000000000000000000000001
100000000000000E000000000E0000000001
100000000000000000000000000000000001
1000000E000000000000000000E000000001
100000000000000000000000000000000001
100E00000000E00000000000000000000001
10000E000000000000000E00000000000001
100000000000000000000000000000E00001
111111111111111111111111111111111111