map.png
3 70 70
1 576 864 70 70
2 504 216 70 70
3 720 864 70 70

22222222222
12222222222
22222222221
22222222222
11111111111
33333333333
33333333333
33333333333
33333333333
11111111111
11111111111