tileset_256.png
16 256 256
1 0 0 256 256
2 256 0 256 256
3 512 0 256 256
4 768 0 256 256
5 0 256 256 256
6 256 256 256 256
7 512 256 256 256
8 768 256 256 256
9 0 512 256 256
a 256 512 256 256
b 512 512 256 256
c 768 512 256 256
d 1024 0 256 256
S 0 0 0 0
E 504 0 70 70
F 0 0 0 0

000000000000000000000000000000000000000000000000000000000000000000000000000000
000000000000000000000000000000000000000000000000000000000000000000000000000000
000000000000000000000000000000000000000000000000000000000000000000000000000000
000000000000000000000000000000000000000000000000000000000000000000000000000000
000000000000000000000000000000000000000000000000000000000000000000000000000000
00000b333333333333c000b333333333333333333c0b333c000000000000000000000000000000
000002000000000000833370000000000000000004020004000000000000000000000000000000
000002000S00000000000000000000000000000059020008333c00000000000000000000000000
000002000000000000000000000000005160000590b70000000400000000000000000000000000
00000a1116000000000000000000511190a1111900200000000400000000000000000000000000
000000000a11111111600000000083333333333333700000000400000000000000000000000000
000000000000000000a60000000000000000000000000000000400000000000000000000000000
0000000000000000000a600000000000000000000000000000083c000000000000000000000000
00000000000000000000a600005116000000000000000000000004000000000000000000000000
000000000000000000000a1111900a111111111111111160000004000000000000000000000000
0000000000000000000000b3333333333333333333333370000004000000000000000000000000
000000000000000000000020000000000000000000000000000049000000000000000000000000
000000000000000000000020000000000000000000000000000590000000000000000000000000
000000000000000000000020000000000000000000000000005900000000000000000000000000
000000000000000000000020000000000000000000000000059000000000000000000000000000
0000000000000000000000a1160000511111111111111111190000000000000000000000000000
000000000000000000000000020000400000000000000000000000000000000000000000000000
000000000000000000000000020000400000000000000000000000000000000000000000000000
000000000000000000000000020000400000b333333c0000000000000000000000000000000000
00000000000000000000000002000040000b700000083cb33cb3333c0000000000000000000000
0000000000000000000000000200004000b7000000000420087000040000000000000000000000
000000000000000000000b333700004b337000000000087000000008333cb333333c0000000000
0000000000000000000002000000008700000000000000000000000000042000000833c0000000
000000000000000000000700000000000000000000000000000000000008700000000083c00000
0000000000000000000b7000000000000000000000000000000000000000000000000000400000
00000000000000000b370000000000000000000000000000000000000000000000000000833c00
000000000000000b37000000000000000000000000000000000000000000000000000000000400
00000000000000b7000000000000000000000000000000000000000000000000000000000008c0
0000000000000b700000000000000000000000511116000000000000000000000000000000008c
000000000000b700000000000000000051111190000a1111111111600000000000000000000004
0000000000b3700000000000000005119000000000000000000000200000000000000000000004
000000000b70000000000000000059000000000000000000000000a11600000000000000000004
000000000200000000560000005190000000000000000000000000000200000000000000000004
00000000b700000051020000519000000000000000000000000000000a11600000000000000059
0000000b70000005003700059000000000000000000000000b3300000000a60000000000000040
000000b70000000837000059000000000000000000000000020083c00000020000000000000590
00000020000000000000004000000000000000000000000b370000400000020000000000000400
00000b700000000000000083333333333333333333333337000000400b33370000000000000400
0000020000000000000000000000000000000000000000000000004b3700000000000000005900
000002000000000000000000000000000000000000000000000000870000000000000000004000
000002000000000000000000000000000000000000000000000000000000000000000000004000
000000600000000000000000000000000000000000000000000000000000000000000000059000
000000a60000000000000000000000000000000000000000000000000000000000000000590000
0000000a1600000000051116000000000000000000000000000000000000000000000000400000
000000000a60000000040002000000000000000000000000000000000000000000000005900000
00000000002000000008c002000000000000000000000000000000000000000000000004000000
0000000000a6000000008c02000000000000000000000000000000000000560000000004000000
00000000000a6000000008c2000000000000000051600000000000000005920000000004000000
000000000000a600000000420000000000000000402000000000000000590a6000000059000000
0000000000000a600000008700000000000000004020000056000000008c0b7000000590000000
00000000000000a600000000000000000000511100a60000420000000008370000005900000000
000000000000000a600000000000000000004b33c00a1111920000000000000000004000000000
0000000000000000a600000000000000000042008c0b33c0020000000000000000059000000000
00000000000000000a600000000000000000870004020083370000000000000000590000000000
000000000000000000a60000000000000000000008370000000000000000000005900000000000
0000000000000000000a6000000000000000000000000000000000000000000059000000000000
00000000000000000000a600000000000000000000000000000000000000000590000000000000
000000000000000000000a60000000000000000000000000000000000000005900000000000000
0000000000000000000000a6000000000000000000000000000000000000004000000000000000
00000000000000000000000a600000000000000000000000000000000000059000000000000000
000000000000000000000000a60000000000000000000000000000000005190000000000000000
0000000000000000000000000a6000000000000000000000000000000059000000000000000000
00000000000000000000000000a600000000000000000000000000005190000000000000000000
000000000000000000000000000a11111111111111111111111111119000000000000000000000


