map.png
3 70 70
1 576 864 70 70
2 504 216 70 70
3 720 864 70 70
20000000000
20000000000
20000000000
20000000000
20000000000
33333333333
33333333333
33333333333
33333333333
11111111111
11111111111